{
"tilesInX": 10, "tilesInY": 10, "tileSize": 200,
"textures": [0,1,2,3,0,1,2,3,0,1,
			 0,1,2,3,0,1,2,3,0,1,
			 0,1,2,3,0,1,2,3,0,1,
			 0,1,2,3,0,1,2,3,0,1,
			 0,1,2,3,0,1,2,3,0,1,
			 0,1,2,3,0,1,2,3,0,1,
			 0,1,2,3,0,1,2,3,0,1,
             0,1,2,3,0,1,2,3,0,1,
             0,1,2,3,0,1,2,3,0,1,
			 0,1,2,3,0,1,2,3,0,1 ]
}